111111111111111111111111111111
100010000000000100000000000001
101010101111110101111111111101
101010101000000101000000000101
101010101011110101011111110101
101010101000010101010000010101
101010101111010101010111010101
101000100000010101010101010101
101110111110110101010101010101
100000100000000101010101010101
111110101111111101010101010101
100000101000000001010101010101
101111101011111111010101010101
101000001010000000010101010101
101011111010111111110101010101
101010000010100000000101010101
101010111110101111111101010101
101010000000100000000001010101
101011111111101111111111010101
101000000000100000000000010101
101111111110111111111111110101
100000000010000000000000000101
111111111011111111111111111101
100000000000000000000000000001
111111111111111111111111111111